Poor living conditions {{c1::breed}} violence and despair.	贫困的生活条件滋生暴力和绝望情绪。
Eagles {{c1::breed}} during the cooler months of the year.	鹰在一年中较凉爽的季节交配繁殖。
{{c1::a sharp bend}} {{c2::in}} the road	路上的一个急转弯
The stones were then {{c1::rounded}}, {{c2::polished}} and {{c3::engraved}}.	接着石头被打圆﹑磨光﹑刻上图案。
In 1972, Nixon himself went to China to set the {{c1::seal}} on the new relationship.	1972年尼克松亲自访华，以确立新的外交关系。
A number of employers have already given their {{c1::seal}} of approval to the {{c2::scheme}}.	一些雇主已经对这项计划表示认可。
The document {{c1::carried}} the {{c2::seal}} of the governor’s office.	文件上盖有州长办公室的章。
an airtight {{c1::seal}} around the windows	窗户四周的密封条
a young film director who is {{c1::on the crest of a wave}} at the moment	目前正处于巅峰时期的一位年轻电影导演
exotic birds with colourful {{c1::crests}}	羽冠鲜艳多彩的珍禽
school / family {{c1::crest}}	校徽/族徽
It took us over an hour to reach the {{c1::crest}} of the hill.	我们花了一个多小时到达山顶。
Actors often have {{c1::butterflies}} before going on stage.	演员上台表演前心里往往非常紧张。
She was suffering from a {{c1::nervous}} condition.	她患上了一种神经系统疾病。
She was so {{c1::nervous}} about her exams that she couldn’t sleep.	考试让她紧张得睡不着觉。
Jess seemed {{c1::on the verge of}} tears.	杰斯似乎差点就要哭了。
The governor was {{c1::impeached}} for using state funds improperly.	州长因违规使用州政府资金而受到弹劾。
The reporter took notes in {{c1::shorthand}}.	这名记者用速记做记录。
We’ll {{c1::go through}} the details later on.	我们稍后再讨论细节。
Dave {{c1::went through}} his pockets looking for the keys.	戴夫翻遍了衣袋找钥匙。
He accepted the offer and the deal {{c1::went through}}.	他接受了这个报价，生意成交了。
We {{c1::went through}} five pints of milk last week.	我们上个星期用了五品脱牛奶。
He’s {{c1::going through}} a divorce at the moment.	目前他正经历离婚的变故。
Let me {{c1::through}} - I’m a doctor.	让我过去——我是医生。
a {{c1::startled}} expression	吃惊的表情
I was {{c1::startled}} to see Amanda.	看到阿曼达，我吃了一惊。
Sorry, I didn’t mean to {{c1::startle}} you.	抱歉，我不是故意吓你一跳的。
{{c1::the deterrent effect}} of {{c2::prison sentences}}	监禁的威慑作用
Window locks are an effective deterrent against {{c1::burglars}}.	窗锁可以有效地阻止窃贼。
{{c1::The small fines}} for this type of crime do not {{c2::act}} as much of {{c3::a deterrent}}.	对于这种罪行，小额罚金起不到多大的威慑作用。
Several gangs were {{c1::operating}} in the area.	有好几个犯罪团伙在这个地区活动。
{{c1::Armed gangs}} have hijacked lorries.	武装犯罪团伙劫持了卡车。
There were always {{c1::gangs of kids}} hanging around the mall.	购物中心一带总有一帮帮的年轻人在游荡。
the problem of {{c1::inner-city}} gang violence	老城区的团伙暴力问题
two rival {{c1::street gangs}}	两个敌对的街头流氓团伙
He was {{c1::busted}} by US inspectors at the border.	他在边境被美国巡官拘捕。
Tony {{c1::busted}} the door down.	托尼把门砸烂了。
a businessman who {{c1::swindled}} investors out of millions of pounds	一个诈骗了投资者数百万英镑的商人
The sky was {{c1::overcast}} and a light rain began to fall.	天空阴云密布，并下起了小雨。
You’ll {{c1::get a good hiding}} when you come home!	你到家后会挨一顿臭揍的！
{{c1::Yield to}} traffic on the left	左侧车辆先行。
They are {{c1::backpedalling}} on the commitment to cut taxes.	他们正在违背减税的承诺。
Please don’t {{c1::tell on me}} - my parents will kill me if they find out!	求你不要去告状——我父母如果知道会宰了我的！
She {{c1::ransacked}} the wardrobe for something to wear.	她为了找可以穿的衣服，把衣柜翻得乱七八糟。
The whole flat had been {{c1::ransacked}}.	整间公寓都遭到洗劫。
We heard a {{c1::bump}} in the next room.	我们听到隔壁房间传来砰的一声。
He had a few {{c1::injuries}}, mostly {{c2::bumps}} and {{c3::bruises}}.	他有几处受了伤，大都是肿块和瘀青。
She has a {{c1::bump}} on the back of her head.	她的后脑勺上肿起了一块。
Hall was found guilty of {{c1::perjury}}.	霍尔被判犯有伪证罪。
We {{c1::marched}} 50 km across the foothills.	我们穿过山麓丘陵行进了50公里。
An {{c1::estimated}} 5,000 people {{c2::marched}} through the city to {{c3::demonstrate}} against the factory {{c4::closures}}.	大约有五千人在市里游行示威，抗议关闭工厂。
Brett {{c1::marched}} out of the office, {{c2::slamming}} the door behind him.	布雷特大步走出办公室，砰的一声摔上了门。
Mr Carter {{c1::marched}} us to the {{c2::principal’s}} office.	卡特先生把我们押到校长办公室。
an {{c1::amnesty}} {{c2::on}} {{c3::illegal handguns}}	交出非法持有手枪的赦免期
The government {{c1::granted}} an {{c2::amnesty}} for all {{c3::former}} terrorists.	该政府大赦了所有前恐怖分子。
The emperor {{c1::issued}} an {{c2::edict}} forbidding anyone to leave the city.	皇帝下令禁止任何人出城。
federal {{c1::programs}} for {{c2::low-income}} {{c3::housing}}	解决低收入家庭住房问题的联邦政府规划
a five-year {{c1::programme}} which will {{c2::create}} 2,000 new jobs	一项能创造2,000个工作机会的五年计划
the government’s {{c2::immigration}} {{c1::policy}}	政府的移民政策
It’s company {{c1::policy}} to allow people to work from home.	允许员工在家办公是公司的政策。
a major new {{c1::initiative}} to {{c2::tackle}} street crime	为应对街头犯罪而新推出的一项重大方案
a peace {{c1::initiative}}	和平倡议
The government’s {{c2::economic}} {{c1::strategy}} has been criticized by many experts.	政府的经济计划受到许多专家的批评。
The government has {{c1::introduced}} a new {{c2::scheme}} to help young people find work.	政府开始推行一项帮助青年人就业的新计划。
a terrorist {{c1::conspiracy}}	恐怖分子的阴谋
There was a {{c1::plot}} to {{c2::assassinate}} the President.	有人密谋刺杀总统。
Leaders {{c1::outlined}} a plan to end the fighting.	领导人略述了结束战事的计划。
a {{c1::pension}} scheme	退休金计划
The {{c1::pilot scheme}} proved to be a great success.	这个试点项目非常成功。
a classification {{c1::scheme}}	分类系统
the {{c1::unimportance}} of man in the whole {{c2::scheme}} of things	世界万物中人类的渺小
a {{c1::get-rich-quick}} scheme	快速致富的手段
The {{c2::benefits}} of the scheme {{c1::outweigh}} the {{c3::disadvantages}}.	这项计划利大于弊。
{{c1::Granted}}, the music is not perfect, but the flaws are {{c2::outweighed}} by the sheer joy of the piece.	诚然，这音乐算不上完美，但曲中欢乐无穷，因而瑕不掩瑜。
immunity {{c1::to}} {{c2::infection}}	对传染病的免疫力
They were {{c1::granted}} {{c2::immunity}} {{c3::from}} {{c4::prosecution}}.	他们获准免受起诉。
The team’s coach was given a {{c1::plaque}}.	那个队的教练得到一块匾牌。
The US has been {{c1::canvassing}} support from other Asian states.	美国一直游说其他亚洲国家，寻求支持。
Chapman spent the rest of May {{c1::canvassing}} for votes.	查普曼用五月份余下的时间拉选票。
The windows had been {{c1::nailed up}}.	窗户被封死了。
Dickie was sent away to school as soon as he was old enough to {{c1::board}}.	迪基一到可以寄宿的年龄就被送去学校了。
Several students {{c1::boarded}} {{c2::with}} Mrs. Smith.	有几名学生寄宿在史密斯夫人家里。
The shop was {{c1::boarded up}}.	这家商店用木板封起来了。
I used a bookmark so that I wouldn’t {{c1::lose my place}} (=forget the point that I had reached).	我用了书签，这样就不会忘记看到哪里了。
{{c1::flakes}} of snow	雪花
a {{c1::brittle}} laugh	冷淡的笑
Joanna was diagnosed as having {{c1::brittle}} bones.	乔安娜被诊断为骨质疏松。
She gave him a {{c1::coy}} smile.	她对他含羞一笑。
{{c1::hunch}} your shoulders: to raise your shoulders into a rounded shape because you are cold, anxious etc	〔因寒冷﹑焦虑等〕耸起双肩
He had to {{c1::hunch}} over {{c2::the steering wheel}} to see anything.	他不伏在方向盘上就什么都看不见。
a {{c1::hunched}} figure sitting {{c2::by}} the fire	弓着背坐在火边的一个身影
{{c1::My hunch}} is that she’s his mother.	我的直觉告诉我她是他母亲。
I had a {{c1::hunch}} that something like this would happen.	我早有预感会发生这样的事情。
Paul {{c1::gave}} me a big hug.	保罗热情地拥抱了我。
{{c1::close-fitting}}: clothes are tight and show the shape of your body	〔衣服〕紧身的
He was hugging {{c1::a big pile of}} books.	他抱着一大堆书。
The small boats {{c1::hugged}} the coast.	小船贴近海岸航行。
She stood {{c1::hugging herself}} {{c2::against}} the cold.	在寒冷中，她抱着胳膊瑟缩站立。
Sarah sat {{c1::on}} the floor, {{c2::hugging}} her {{c3::knees}}.	萨拉抱着双膝坐在地板上。
We stood there crying and {{c1::hugging}} each other.	我们站在那里哭着互相拥抱。
She {{c1::hunched}} {{c2::over}} the desk, telephone {{c3::cradled}} {{c4::at}} her neck.	她伏在桌上，脖子上夹着电话听筒。
John {{c1::cradled}} the baby {{c2::in}} his arms.	约翰把宝宝轻轻抱在怀里。
a {{c1::window-cleaner’s}} {{c2::cradle}}	窗户清洁工的吊篮
She {{c1::replaced}} the {{c2::receiver}} on the {{c3::cradle}}.	她把听筒放回听筒架上。
{{c1::From cradle to grave}}, the car marks every rite of American passage.	汽车见证着美国人从生到死每一个重要的人生阶段。
Athens is often regarded as the {{c1::cradle}} of democracy.	雅典常常被认为是民主的发源地。
She {{c2::rocked}} the {{c1::cradle}} to quieten the child.	她摇动摇篮，让宝宝安静下来。
Drury {{c1::harboured}} {{c2::bitterness}} in his {{c3::bosom}}.	德鲁里怀恨在心。
She {{c1::cradled}} the child {{c3::to}} her {{c2::bosom}}.	她把那孩子抱入怀中。
the {{c1::poaching}} of elephants for their {{c2::ivory tusks}}	为获取象牙偷猎大象的行为
characters {{c1::poached}} from Shakespeare	从莎士比亚作品中剽窃的人物
Several of their reporters were {{c1::poached}} from other {{c2::papers}}.	他们有几个记者是从其他报社挖过去的。
That company’s always {{c1::poaching}} our {{c2::staff}}.	那家公司老是挖我们的员工。
Deer have been {{c1::poached}} here for years.	多年来这里一直有人偷偷地猎鹿。
His eyes were {{c1::rimmed}} with {{c2::fatigue}}.	他的眼里满是倦意。
Local people have {{c1::banded together}} to {{c2::fight}} the company’s plans.	当地民众联手抵制该公司的计划。
{{c1::rimless}} {{c2::glasses}}	无框眼镜
{{c1::red-rimmed}} eyes	眼眶红红的眼睛
{{c1::gold-rimmed}} {{c2::spectacles}}	金边眼镜
The birds have a distinctive blue {{c1::band}} round their eyes.	这种鸟的眼圈是蓝色的，很特别
a {{c1::slim}} gold {{c2::band}} {{c3::on}} her finger	她手指上戴的一枚细细的金指环
papers {{c1::held together}} with a {{c2::rubber band}}	用橡皮筋捆在一起的文件
people within the $20,000-$30,000 {{c1::income band}}	收入在两万至三万美元这个范围的人
{{c1::Interest rates}} stayed within a {{c2::relatively}} {{c3::narrow}} {{c4::band}}.	利率在一个相对较小的范围内波动。
a small {{c1::band}} of volunteers	一小批志愿者
interviews with {{c1::band members}}	对乐队成员的采访
the {{c1::rim}} of a glass	玻璃杯口
He was continually {{c1::dreaming up}} new schemes to {{c2::promote}} and {{c3::enlarge}} the business.	他不断想出奇特的新计划来促进和扩大业务。
The company has threatened to {{c1::dock}} the officers’ pay.	公司威胁说要给那几名高级职员降薪。
We {{c1::docked}} at Rangoon the next morning.	第二天早晨我们在仰光停靠码头。
an ocean {{c1::liner}}	远洋客轮
a dustbin {{c1::liner}}	垃圾袋
James arrived {{c1::at the docks}} expecting to see a {{c2::luxury liner}}.	詹姆斯来到码头区，希望看到豪华邮轮。
Three {{c1::defendants}} stood {{c2::in the dock}}.	三名被告站在被告席上。
{{c1::cash cow}}: something that a company sells very successfully and that {{c2::brings in}} a lot of money	稳赚项目；摇钱树；财源
{{c1::bullseye/bull’s-eye}}: the centre of a TARGET that you try to hit when shooting or in games like DARTs	靶心
The King {{c1::decreed}} that there should be an end to the fighting.	国王下旨结束这场战斗。
The Emperor issued the {{c1::decree}} {{c2::repealing}} {{c3::martial law}}.	皇帝下诏令取消了军事管制。
O’Malley {{c1::downed}} his opponent in the first {{c2::round}}.	奥马利第一回合就把对手击倒。
He made only {{c1::a passing reference}} to her achievements.	他仅仅顺便提了提她的成就。
He had only ever shown {{c1::a passing interest}} in sport.	对于体育运动，他只是曾经表现出一时的兴趣。
{{c1::With each passing day}} she grew stronger.	她一天比一天强壮起来。
Her {{c1::grief}} became less {{c2::intense}} with the {{c3::passing}} years.	随着光阴的流逝，她的悲伤不那么强烈了。
A {{c1::passing}} {{c2::motorist}} stopped to help.	一位驾车经过的司机停下来帮忙。
Michael watched the {{c1::passing}} cars.	迈克尔注视着来往的汽车。
When someone is {{c1::down on their luck}}, friends are very difficult to find.	一个人穷困潦倒的时候很难找到朋友。
Well, you’ve passed your second test, so it’s two {{c1::down}} and {{c2::four more to go}}.	好，你已经通过了第二项测验，那么已有两项完成，还有四项。
{{c1::Down}} {{c2::with}} the government!	打倒政府！
The plans were all complete {{c1::down to}} the last detail.	计划连最后的细节都已经敲定了。
We’re {{c1::down to}} our last five dollars.	我们只剩下最后五美元了。
Chris’s success is all {{c1::down to him}}.	克里斯的成功完全是他自己努力的结果。
It’s {{c1::down}} to me to make sure that everyone is happy.	让每个人愉快是我的责任。
if a computer is {{c1::down}}, it is not working	停止工作的，停机的，不运行的
Tim’s been feeling {{c1::down}}.	蒂姆最近情绪很低落。
Meg’s been very ill and can’t {{c1::keep}} her food {{c1::down}}.	梅格病得很重，咽不下东西。
A top quality {{c1::freezer}} for only £20 {{c2::down}} and £5 a week for a year.	一台优质的冰柜只需20英镑首付款，余额每周付5英镑，一年内付清。
We’ve already {{c1::put his name down}} for nursery school.	我们已经给他报名上幼儿园了。
I’ll {{c1::write down}} the address for you.	我替你把地址写下来。
Let’s {{c1::put you down}} as self-employed.	我们就写你是自由职业者吧。
Start by {{c1::jotting down}} a few ideas.	开始先记下几个想法
Swindon were six points {{c1::down}} {{c2::at one stage}}.	斯温登队一度落后六分。
Sharif cut his report {{c1::down}} to only three pages.	沙里夫把报告删减到只有三页。
Turn the radio {{c1::down}}.	把收音机的音量调低。
House prices have {{c1::come down}} in recent months.	最近几个月房价降下来了。
Keep your speed {{c1::down}}.	速度放慢。
The {{c1::coffin}} {{c2::lid}} had been {{c3::nailed}} {{c4::down}}.	棺盖已被钉上。
Chunks of ice came {{c1::floating}} down the river.	大块大块的冰顺河漂下。
I saw her {{c1::down}} {{c2::at the station}} this morning.	今天早上我在附近的车站看见了她。
They {{c1::sailed}} {{c2::down}} the east {{c3::coast}} of Africa.	他们驾船沿非洲东海岸南下。
They drove all the way {{c1::down}} from Boston to Miami.	他们从波士顿开车南下一直到迈阿密。
The bus stop is a bit further {{c1::down}} on the left-hand side.	公共汽车站还要往前一点，在左边。
There is a pleasant little cafe bar a hundred yards {{c1::down the road}}.	沿这条路往前100码处有家很舒适的小咖啡馆。
She {{c1::looked down the road}} to see if anyone was coming.	她顺着马路望去，看是否有人来。
I think I’ll go and {{c1::lie down}} for a while.	我想去躺一会儿。
{{c1::Halfway down the page}}, there was the item I was looking for.	在这一页中间有我在找的内容。
The bathroom is {{c1::down}} those stairs.	浴室在那段楼梯下面。
Ken fell asleep {{c1::face down}} (=with his face towards the ground) {{c2::on the couch}}.	肯趴在长沙发上睡着了。
Her hair {{c2::came}} {{c1::down}} to her {{c3::waist}}.	她的头发一直垂到腰际。
She stood {{c1::on a balcony}} looking down into the {{c2::courtyard}}.	她站在阳台上朝下面的院子望去。
They came {{c1::running down}} the stairs.	他们跑下楼来。
Tears were {{c1::streaming}} down my face.	我泪流满面。
David {{c1::bent down}} to {{c2::tie}} his {{c3::shoelace}}.	戴维弯腰系鞋带。
Nothing could {{c1::fill the gap}} in her life left by {{c2::his passing}}.	他去世后什么都无法填补她生活的空虚。
The old {{c1::regime}} was defeated, and few people mourned its {{c2::passing}}.	旧政权被打垮，几乎没有人对其消亡感到痛惜。
He did mention his brother’s wife, but only {{c1::in passing}}.	他确实提到了他的弟媳，但只是顺带而已。
The {{c1::passing}} of the {{c2::years}} had done nothing to improve his {{c3::temper}}.	岁月的流逝一点也没有让他的坏脾气有所好转。
Most of the old traditions have {{c1::died out}} with the {{c2::passing}} of time.	随着时间的推移，大多数古老传统都已消亡。
With the {{c1::passage}} of {{c2::time}}, things began to look more hopeful.	随着时间的流逝，事情开始显得更有希望。
The police forced a {{c1::passage}} {{c2::through}} the {{c3::crowd}}.	警察在人群中辟出一条通道。
They are expecting the new {{c2::legislation}} to have {{c1::quite a rough passage}} (=be discussed and criticized a lot) through Parliament.	他们预计新的法律在议会通过时会遭遇重重困难。
The {{c1::bill}} was {{c2::amended}} several times during its {{c3::passage}} {{c4::through}} Congress.	那项法案在提交国会通过时作过几次修正。
Both sides agreed to allow {{c1::the free passage}} of medical supplies into the area.	双方都同意允许医疗用品自由运入该地区。
He was guaranteed {{c1::safe passage}} out of the country.	他得到保证可以安全离境。
The bridge isn’t strong enough to allow the {{c1::passage}} of {{c2::heavy vehicles}}.	那座桥不够坚固，无法让重型车辆通过。
He {{c1::read out}} a {{c2::short}} {{c3::passage}} from the Bible.	他朗读了《圣经》里的一小段。
We walked down {{c1::a narrow passage}} to the back of the building.	我们沿着一条狭窄的通道来到大楼的后面。
an {{c1::underground}} {{c2::passage}}	地下通道
{{c1::the industrial corridor}} that connects Querétaro with Mexico City	连接克雷塔罗和墨西哥城的工业地带
We had to wait outside {{c1::in the corridor}} until our names were {{c2::called}}.	我们只好在外面的走廊上等候叫我们的名字。
A {{c1::priest}} came to give him {{c2::the last rites}}.	一位神父来为他做临终祷告。
{{c1::funeral}} {{c2::rites}}	殡葬仪式
Everyone uses the {{c2::cafeteria}}, {{c1::from}} the managing director {{c1::down to}} the office boy.	上至常务董事下至办公室的工友，大家都在食堂用餐。
She {{c1::went to}} her daughter and hugged her {{c2::tightly}}.	她走到女儿身边，紧紧地拥抱她。
a {{c1::peanut butter}} and {{c2::jelly}} sandwich	加花生酱和果酱的三明治
He was {{c1::revolted}} by the smell.	那气味让他恶心。
Some members of the government may {{c1::revolt}} against this {{c2::proposed}} legislation.	一些政府成员可能会反对这项拟议中的法规。
It was {{c1::feared}} that the army would {{c2::revolt}} against the government.	有人担心军队会挥戈反对政府。
Troops loyal to the President {{c1::crushed}} the {{c2::revolt}}.	忠于总统的军队镇压了叛乱。
French farmers are in {{c1::revolt}} {{c2::over}} cheap imports.	法国农场主正在抵制廉价的进口产品。
a revolt {{c1::over}} the proposed {{c2::spending cuts}}	对缩减开支提案的反对
a revolt {{c1::against}} {{c2::authority}}	对权威的反抗
The {{c2::prime minister}} is now facing a {{c1::revolt}} by {{c3::members of his own party}}.	首相现在面临着党内倒戈。
My heart was {{c1::pumping}} fast.	我的心怦怦直跳。
He got a job {{c1::pumping gas}} for the hotel guests.	他得到一份为宾馆客人的汽车加油的工作。
We were able to {{c1::pump}} clean water from several of the {{c2::wells}}.	我们能从几口井里抽出干净的水来。
{{c1::The fire department}} is still {{c2::pumping}} floodwater out of the {{c3::cellars}}.	消防人员仍在用水泵从地下室里往外抽积水。
{{c1::pump iron}}: [informal] to do exercises by lifting heavy weights	【非正式】 举重
She’s {{c1::suffering}} from {{c2::severe}} {{c3::depression}}.	她患有严重的抑郁症。
His {{c2::injuries}} were quite {{c1::serious}}.	他的伤势非常严重。
His slightly {{c1::severe}} {{c2::expression}} {{c3::softened}}.	他原本有点严厉的表情变柔和了。
a rather {{c1::severe}} {{c2::red-brick}} building	一幢相当简朴的红砖建筑
The negotiations will be {{c1::a severe test}} of his abilities.	这次谈判将是对他能力的严峻考验。
The president {{c1::came under}} severe criticism for his handling of the crisis.	总统对这场危机的处理方式受到了严厉的批评。
Drug {{c1::smugglers}} can {{c2::expect}} {{c3::severe penalties}}.	毒品贩子会受到重判。
a first date with your {{c1::crush}}	和你心仪的人的初次约会
It’s just a {{c1::schoolgirl}} crush.	那只是小女生的一种痴情。
She had a {{c3::huge}} {{c1::crush}} {{c2::on}} her geography teacher.	她对地理老师非常迷恋。
There’s always such a {{c1::crush}} on the train in the mornings.	早晨火车上总是那么拥挤。
a guy in my class that I’m {{c1::crushing}} {{c2::on}}	我班上的一个我很迷恋的家伙
Sara was {{c1::crushed}} by their {{c2::insults}}.	萨拉因他们的侮辱而非常伤心。
{{c1::crush}} sb’s hopes / {{c2::enthusiasm}} / confidence etc: to make someone lose all hope, confidence etc	粉碎某人的希望/热情/信心等
{{c1::crush}} a {{c2::rebellion}} / {{c3::uprising}} / {{c4::revolt}} etc: to use severe methods to stop people from fighting you or opposing you	平定叛乱/起义/反叛等
The {{c1::revolution}} was {{c2::crushed}} within days.	几天之内这场革命就被镇压了。
{{c1::Crush}} two {{c2::cloves}} of garlic.	捣两瓣大蒜。
Two people were {{c1::crushed to death}} in the {{c2::rush}} to {{c3::escape}}.	两个人在逃生过程中被踩死。
His leg was {{c1::crushed}} in the accident.	他的腿在事故中被压断。
the {{c1::spectacle}} of {{c2::drunken}} young men on the streets	街上年轻醉汉的丑态
The {{c1::trial}} was {{c2::turned}} into a public {{c3::spectacle}}.	审判变成了一场公开的闹剧。
a multimedia dance and opera {{c1::spectacle}}	盛大的多媒体舞蹈戏剧表演
They receive a grant of £1,094 to cover the cost of {{c1::miscellaneous}} {{c2::expenses}}.	他们获得1,094英镑的津贴用于支付各种开支。
Do you know {{c1::what time it is}}?	你知道现在几点吗？
There are {{c1::instructions}} telling you everything you need to know.	操作指南会告诉你所有须知事项。
if a government {{c1::repeals}} a law, it officially ends that law	废除〔法律〕
the {{c1::appropriation}} of company {{c2::property}}	侵吞公司财产
the {{c1::appropriation}} of $2 million for the new hospital	用于新医院的200万美元拨款
{{c1::appropriately}} {{c2::dressed}}	穿着得体的
Where {{c1::appropriate}} , I {{c2::delegate}} as much work as possible.	只要合适，我就尽量把工作分派出去。
I thought his {{c4::remark}} was highly {{c1::appropriate}}, {{c2::given}} the {{c3::circumstances}}.	考虑到当时情况，我认为他的话很恰当。
I didn’t feel that this was {{c1::an appropriate time}} to {{c2::mention}} the {{c3::subject}} of money.	我觉得这个时候不适合提钱的问题。
It would not be {{c1::appropriate}} for me to discuss that now.	现在我不宜讨论此事。
an education system which is more {{c1::appropriate}} {{c2::to}} the needs of the students	更切合学生需求的教育制度
clothes {{c1::appropriate}} {{c2::for}} {{c3::a job interview}}	适合求职面试穿的服装
Congress {{c1::appropriated}} $5 million for International Women’s Year.	国会为国际妇女年拨款500万美元。
He is {{c1::suspected of}} {{c2::appropriating}} government {{c3::funds}}.	他被怀疑挪用政府资金。
There was {{c1::a major upset}} when the young skater {{c2::took}} the gold medal.	那位年轻的滑冰运动员夺得了金牌，爆了个大冷门。
The soup was {{c1::revolting}} and {{c2::upset my stomach}}.	那汤令人作呕，让我的肠胃很不舒服。
Jones {{c1::upset}} the 40th-ranked American, Cunningham.	琼斯出人意料地打败了排名第40位的美国选手坎宁安。
He {{c1::upset}} a {{c2::bowl}} of soup.	他打翻了一碗汤。
The {{c2::chemicals}} {{c1::upset}} the balance of the environment.	这些化学品破坏了环境的平衡。
Don’t do anything that would {{c1::upset}} him.	别做惹他生气的事情。
Debbie was {{c1::upset}} that he didn’t spend more time with her.	他没有花更多的时间陪自己，黛比觉得不快。
She was deeply {{c1::upset}} {{c2::about}} the way her father treated her.	父亲那样对她，她非常难过。
You’re not still {{c1::upset}} {{c2::with}} me, are you?	你不是还在生我的气吧？
The {{c1::bill}} would have {{c2::outlawed}} several types of guns.	这项法案将全面禁用几种枪支。
I’ve never been able to {{c1::stomach}} seafood.	我从来都吃不了海鲜。
She felt her stomach {{c1::rumble}}.	她觉得肚子饿得咕咕叫。
I had {{c2::terrible}} {{c1::stomach ache}} last night.	昨天晚上我胃痛得厉害。
Debbie was at home because she had an {{c1::upset stomach}}.	黛比在家,因为她胃不舒服。
It was 11 o'clock, and my {{c1::stomach}} was {{c2::empty}}.	11 点了,我的胃都空了。
A lot of these children don't know {{c2::what it is like}} to have {{c1::a full stomach}}.	这些孩子中有许多人不知道吃饱是什么感觉。
Don’t {{c3::go and see}} this film unless you have a {{c2::strong}} {{c1::stomach}}.	如果没有很强的承受力就不要去看这部电影。
The {{c2::sight}} of the {{c3::slaughtered}} cow {{c1::turned}} my stomach.	看到被宰杀的牛我感到恶心。
You shouldn’t take the pills {{c1::on an empty stomach}}.	你不可以空腹吃这些药片。
He {{c3::turned round}} and {{c2::punched}} Carlos in the {{c1::stomach}}.	他转过身一拳打在卡洛斯的腹部。
His {{c1::stomach}} was {{c2::full of}} food.	他的胃里塞满了食物。
She was becoming {{c1::an emotional prop}} for him.	她成了他的感情支柱。
Anna {{c3::looks after}} {{c1::costumes}} and {{c2::props}}.	安娜管理服装和道具。
{{c1::Don’t sweat it}}, I’ll {{c2::lend}} you the money.	别担心，我会借给你钱的。
Italy’s {{c2::championship hopes}} eventually {{c1::bit the dust}}.	意大利队夺冠的希望最后化为了泡影。
{{c1::medals}} {{c2::awarded}} for {{c3::valor}}	表彰英勇的勋章
{{c2::deeds}} of {{c1::valour}}	英勇事迹
{{c1::discretion}} is the better part of {{c2::valour}}: used to say that it is better to be {{c3::careful}} than to {{c4::take unnecessary risks}}	知进退方可言大勇，知慎近乎勇
British newspapers no longer feel they must treat the royal family with {{c1::discretion}}.	英国报界不再觉得他们非得审慎对待王室不可了。
The committee has {{c1::the absolute discretion}} to refuse applications.	委员会拥有绝对的权力拒绝申请。
The judge {{c1::exercised}} his {{c2::discretion}} rightly to admit the evidence.	法官正确地行使了决定权，接受了该项证据。
People want to have more {{c1::discretion}} {{c2::over}} their working hours.	人们要求对工作时间有更多的自主权。
Promotions are {{c2::left to}} the {{c1::discretion}} of the supervisor.	晋升由主管决定。
The awards are made at the {{c1::discretion}} of the committee.	获奖者由委员会决定。
the government’s plans to {{c1::shake up}} the educational system	政府改革教育体系的计划
I had to {{c1::forgo}} lunch.	我只得放弃午餐。
Buying a house will be a {{c1::hedge}} against inflation.	买房子是应对通货膨胀的一种防范手段。
‘That depends on my partner,’ she {{c1::hedged}}.	“那取决于我的合伙人。”她避重就轻地答道。
You’re {{c1::hedging}} again - have you got the money or haven’t you?	你又在闪烁其词了，你究竟有没有钱？
It’s a good idea to {{c1::hedge your bets}} by applying to more than one college.	同时向几所大学提出申请是个保险的好主意。
{{c1::hedge your bets}}: to reduce your chances of failure or loss by trying several different possibilities instead of one	多处下注以减少风险，对冲风险
Ooh, {{c1::gross}}! I hate spinach!	呃，恶心！我讨厌吃菠菜！
{{c1::gross}} {{c2::indecency}} (=the {{c3::crime}} of doing something that is sexually {{c4::offensive}})	严重猥亵罪
soldiers accused of {{c1::gross}} {{c2::violations}} of human rights	被指控严重侵犯人权的士兵
a {{c1::gross}} profit of $5 million	500万美元的毛利
Vernon estimates the company’s {{c1::net worth}} {{c2::at}} over $8 billion.	弗农估算公司的资产净值超过80亿美元。
The {{c1::net profit}} (=after {{c2::taxes}}, {{c3::costs}} etc) was {{c4::up}} 16.3% last month.	上个月净利润增长了16.3%。
The {{c1::net result}} will be higher costs to the consumer.	最后的结果是消费者将支付更高的费用。
jars of coffee {{c2::weighing}} 450 grams {{c1::net}}	净重450克的一罐罐咖啡
{{c1::suffrage}}: the right to vote in national elections	选举权，投票权
The end of his finger had been {{c1::cut off}}.	他手指被切断了一截。
The children's father had {{c1::cut off}} all {{c2::contact}} with them.	父亲和孩子们断绝了一切联系。
She had {{c1::severed}} all contact with her ex-husband.	她和前夫断绝了一切往来。（常用cut off）
The two countries {{c1::severed}} diplomatic {{c2::relations}}.	这两个国家断绝了外交关系。
He {{c2::peeped}} {{c1::inquisitively}} {{c3::into}} the drawer.	他好奇地往抽屉里窥视。
an {{c1::inquisitive}} {{c2::mind}}	好钻研的性格
a {{c1::cheerful}}, {{c2::inquisitive}} little boy	一个快乐﹑好问的小男孩
I’d have asked more questions, but I didn’t want to seem {{c1::inquisitive}}.	我本想问更多的问题，但我不想看上去那么爱打听。
{{c1::sugar daddy}}: [informal] an older man who gives a young person presents and money in return for their {{c2::company}} and often for {{c3::sex}}	【非正式】 〔以礼物和金钱换取年轻女人陪伴或性好处的〕老色迷，阔干爹，甜爹
This view is not widely {{c1::held}}.	持这种观点的人并不多见。
She was {{c1::held to be}} one of the most talented actors {{c2::of her time}}.	她被认为是她那个时代最有天赋的演员之一。
The judge {{c1::held}} that the child’s {{c3::interests}} in this case must {{c2::come first}}.	法官认为，该案必须首先考虑孩子的利益。
He was kept in {{c1::appalling}} conditions in prison.	他被关在环境极其恶劣的监狱中。
The decision to {{c2::execute}} the two men has {{c1::appalled}} many politicians.	处死那两名男子的判决令许多从政者震惊。
‘Do you {{c2::mind}} if I look at your notes?’ ‘{{c1::Be my guest}}.’	“我看一下你的笔记，行吗？”“随便看吧。”
a {{c1::banquet}} for 250 {{c2::distinguished}} guests	250位贵宾出席的宴会
a state {{c1::banquet}} (=one attended by {{c2::heads of government}} and other important people )	国宴
The Prime Minister is unlikely to {{c1::endorse}} this view.	首相不可能赞同这一观点。
By the end of the meeting we had begun to {{c1::flag}}.	会议结束时，我们已经开始打蔫了。
I’ve {{c1::flagged}} the parts I want to comment on.	我已经标示出我要评论的部分。
{{c1::ethnic}} cooking / fashion / design etc: cooking, fashion etc from countries that are far away, which seems very different and unusual	具有异国风情的烹调/时尚/设计等
The students are from a variety of {{c1::ethnic backgrounds}}.	学生的种族背景各不相同。
The school teaches {{c2::pupils}} from different {{c1::ethnic groups}} .	该校教授不同种族的小学生。
Learning poetry is a good {{c1::discipline}} for the memory.	背诗是训练记忆力的一种好方法。
Martial arts teach {{c1::respect}}, {{c2::discipline}}, and {{c3::cooperation}}.	武术能教人尊重他人﹑遵守纪律并且相互合作。
A lot of the kids seemed to {{c2::lack}} {{c1::self-discipline}}.	这些小孩中有许多好像都缺乏自我约束力。
The book gives parents advice on {{c1::discipline}}.	这本书指导父母如何管教孩子。
serious {{c1::discipline}} problems in the police force	警察队伍内严重的纪律问题
As things got worse {{c3::at work}}, he began to use {{c2::alcohol}} as a {{c1::crutch}}.	工作每况愈下，他就开始借酒消愁。
I was {{c1::on crutches}} for three months after the operation.	手术后我拄了三个月的拐杖。
Use the spices {{c1::sparingly}} .	这种香料只要用一点点。
an attempt to {{c1::trip up}} the Prime Minister on policy issues	诱使首相在政策问题上犯错的企图
He {{c1::chased}} the thief, {{c2::tripped him up}}, and {{c3::grabbed}} the camera.	他追上盗贼，把他绊倒后夺回了相机。
Always try a sleeping bag {{c1::for size}} before you buy it.	买睡袋之前一定要试试大小是否合适。
a woman well {{c1::versed}} in the art of diplomacy	熟谙外交手腕的女人
the {{c1::disclosure}} of private medical information	私人医疗信息的泄露
My father was {{c1::spouting}} his usual {{c2::nonsense}}!	我父亲又在没完没了地讲他那些废话了！
I hate it when he {{c1::spouts off}} like that!	我讨厌他像那样讲个没完！
I’m tired of listening to Jim {{c1::spouting about}} politics.	我听腻了吉姆大谈政治。
a {{c2::volcano}} {{c1::spouting}} {{c3::lava}}	喷发着熔岩的火山
Blood was {{c1::spouting}} from the wound {{c2::in}} her arm.	血从她手臂的伤口涌出。
{{c2::The sudden fall}} {{c3::on the stock market}} {{c4::sent}} {{c5::brokers}} {{c1::into a spin}}.	股市突然下跌使经纪人惊慌失措。
They tried to put {{c1::a positive spin}} on the sales figures.	他们试图美化销售数字。
the Earth’s {{c1::spin}}	地球的自转
It was a real {{c1::bummer}} being ill {{c2::on holiday}}.	在假期里生病真扫兴。
Meg and Neil were {{c2::due to}} marry, but she {{c1::ditched}} him.	梅格与尼尔本来是要结婚的，可她把他给甩了。
The government has {{c1::ditched}} plans to privatise the prison.	政府放弃了监狱私有化的计划。
I’ll {{c1::vouch}} for the quality of the report. I read it last night.	我为报告的质量作保，我昨晚看过。
‘Where were you {{c2::on the night of the murder}}?’ ‘{{c3::In bed with flu}}. My wife can {{c1::vouch for that}}.’	“谋杀发生当晚你在哪里？”“患流感卧床，我妻子可以作证。”
Tania {{c1::chucked}} her bag down on the sofa.	塔妮娅把包随手扔在沙发上。
I think I might have {{c1::chucked}} it {{c2::by mistake}}.	我想可能是我无意中把它扔掉了。
There was {{c2::silence}} while she {{c1::deliberated}} on his words.	她掂量着他的话，四周一片沉默。
The jury {{c1::deliberated}} for four days before {{c2::acquitting}} him.	陪审团斟酌了四天之后裁断他无罪。
a {{c1::deliberate}} attempt to {{c2::humiliate}} her	对她的故意羞辱
an expensive {{c2::court battle}} that could {{c1::drag on}} for years	可能拖延好几年的费用昂贵的官司
You can {{c1::drag and drop}} text like this.	你可以这样拖放文本。
Mom {{c1::dragged}} us to a classical music concert.	妈妈拉我们去听了一场古典音乐会。
Can you {{c1::drag yourself away from}} (=stop watching) the TV for a minute?	你能停一下不看电视吗？
I {{c1::dragged myself}} {{c2::out of bed}} and into the bathroom.	我吃力地下床走进浴室。
He {{c1::grabbed}} her arm and {{c2::dragged}} her into the room.	他抓住她的手臂把她拖进房间。
Inge {{c2::managed to}} {{c1::drag}} the table into the kitchen.	英奇费了很大劲把桌子拖进厨房里。
The group’s influence had begun to {{c1::wane}} by this time.	此时，这个团体的影响力已经开始减弱。
My {{c2::enthusiasm}} for the project was {{c1::waning}}.	我对这个项目的热情逐渐减退了。
oil / petroleum / sugar {{c1::refinery}}	炼油厂/制糖厂
It left a black {{c1::smear}} {{c2::on}} his arm.	这在他的左臂上留下了一点黑色的污迹。
an {{c2::attempt}} to {{c1::smear}} the party leadership	污蔑党领导的企图
Elaine {{c1::smeared}} suntan lotion on her shoulders.	伊莱恩把防晒霜胡乱抹在 肩上。
His face was {{c1::smeared}} with {{c2::mud}}.	他满脸泥污。
The {{c2::constant}} criticism was beginning to {{c1::undermine her confidence}}.	不断的批评开始削弱她的信心了。
economic policies that {{c2::threaten}} to {{c1::undermine}} the health care system	可能会损害医疗保健制度的经济政策
two’s {{c1::company}}, three’s a {{c1::crowd}}: used to suggest that two people would rather be alone together than have other people with them	两人为伴，三人不欢〔用来表示宁可只有两个人而不要更多的人加入他们〕
be {{c1::in good company}}: used to tell someone who has made a mistake that they should not be {{c2::embarrassed}} because some important or respected people have made the same mistake	一些大人物也这样〔用于安慰犯了错误的人〕
If you can’t program the video recorder, you’re {{c1::in good company}}.	你不会预设录像机又怎么啦，不会的又不是就你一个。
Things began to go wrong when he got into bad {{c1::company}}.	他交上坏朋友之后问题就来了。
We’re expecting {{c1::company}} this evening.	今晚我们有客人要来。
Come over for dinner - I could {{c1::use the company}} (=would like to be with people) .	过来吃饭吧，我也好有个伴。
The two men enjoy each other’s {{c1::company}}.	这两个人喜欢在一起。
Your passport application form should be {{c1::accompanied}} by two recent photographs.	护照申请表应附近照两张。
Daniel wanted Liz to {{c1::accompany}} him {{c2::on}} violin.	丹尼尔想让丽兹用小提琴为他伴奏。
The disease is {{c1::accompanied by}} sneezing and fever.	这种病伴有打喷嚏和发烧症状。
Do you want me to {{c1::go with}} you to the station?	你想不想让我陪你去车站？
He {{c1::twisted}} his head slightly, and looked up at her.	他微微扭过头，抬眼看着她。
an unexpected {{c1::twist}} in the plot	故事情节意想不到的转折
{{c1::think tank}}: a group of people with experience or knowledge of a particular subject, who work to {{c2::produce ideas}} and {{c3::give advice}}	智囊团，智库〔就某方面问题出谋划策的专家小组〕
There was no evidence that he had {{c1::incited}} members of the group to {{c2::violence}}.	没有证据证明他唆使该团体成员使用暴力。
a person who {{c1::incites}} others to commit an offence	教唆他人犯罪的人
They were charged with {{c1::inciting}} racial hatred.	他们被指控煽动种族仇恨。
{{c1::heavy-handed}}: taking too much action or extreme action, especially without thinking about other people’s feelings	粗暴的；严厉的；高压的
a {{c1::heavy-handed}} style of management	高压管理方式
Candidates should engage in serious political {{c1::discourse}}.	候选人应该参加严肃的政治对话。
The project has been set up in {{c1::liaison}} with the art department.	该项目是和艺术系联合设立的。
close {{c1::liaison}} between the army and police	军警之间的密切联系
If he’s had a bad day, Paul {{c1::vents}} his anger on the family.	要是哪天过得不顺心，保罗就会在家人身上出气。
The measures are meant to {{c1::stem}} the {{c2::tide}} of illegal immigration.	这些措施旨在遏制非法移民潮。
A tight {{c2::bandage}} should {{c1::stem}} the bleeding.	扎紧绷带可以止血。
an attempt to {{c1::stem}} the {{c2::decline}} in profits	遏制利润下滑的努力
His headaches {{c1::stemmed}} from vision problems.	他的头痛是由视力问题引起的。
the {{c1::debacle}} of the 1994 elections	1994年大选的惨败
{{c1::a life of ease}}: a comfortable life, without problems or worries	安逸的生活
The bowl is removable {{c1::for ease of}} cleaning.	这个碗状物可取出以方便清洗。
You always look {{c1::ill at ease}} in a suit.	你穿套装看上去总有些不自在。
She had an ability to put people {{c1::at their ease}}.	她有能力让人们感到自在。
She felt completely {{c1::at ease with}} Bernard.	她和伯纳德在一起感到很自在。
The security codes could be {{c2::broken}} {{c1::with relative ease}}.	破译那些安全密码相对容易。
I was impressed by the {{c1::ease}} {{c2::with which}} the information could be {{c3::retrieved}}.	资料能够轻易检索到，这让我印象深刻。
if something that you value very much is {{c1::at stake}}, you will lose it if a plan or action is not successful	有风险，成败难料
They have to win the contract - thousands of jobs are {{c1::at stake}}.	他们必须拿下这份合同，这关系到数千个工作岗位。
Don’t allow yourself to be {{c1::swayed}} by his promises.	你可不要听了他的许诺就改变主意呀。
The trees {{c1::swayed}} gently in the {{c2::breeze}}.	树木在和风中轻轻摇曳。
the {{c1::sway}} of the ship	船的摇晃
She was now completely under his {{c1::sway}}.	她现在完全受他的支配。
These old attitudes still {{c1::hold}} {{c2::sway}} in the church.	这些旧观念在教会中仍占支配地位。
{{c1::ad hoc}} committee / group etc	特别委员会/小组等
decisions made on an {{c1::ad hoc basis}}	临时作出的决定
{{c2::Momentous}} events are {{c1::taking place}} in the US.	美国正在发生重大事件。
His colleagues all recognized that this was a {{c2::momentous}} {{c1::occasion}}.	他的同事都认识到这是一个重要时刻。
a {{c1::momentous}} {{c2::decision}}	重大决定